border_size=1
usage=map

Wo, Wo, Ce, Ce, Ce, Ce, Ce, Ce, Ce, Re, Rr, Re, Ce, Ce, Ce, Ce, Ce, Ce, Ce, Ce, Wo, Wo
Wo, Wo, Ce, Ce, Ce, Ce, Ce, Ce, Ce, Re, Rr, Re, Ce, Ce, Ce, Ce, Ce, Ce, Ce, Ce, Wo, Wo
Wo, Wo, Ce, Gg, Gs^Fp, Gs^Fp, Gs^Fp, Gg, Gg, Gg, Rr, Gg, Gg, Gg, Gg, Gg, Re^Gvs, Gg, Gg, Ce, Wo, Wo
Wo, Wo, Ce, Gs^Fp, Hh^Vhh, Gg^Fet, Gs^Fp, Gg, Gg, Gg, Rr, Gg, Gg, Gg, Re^Gvs, Re^Gvs, Re^Gvs, Re^Gvs, Re^Gvs, Ce, Wo, Wo
Wo, Wo, Ce, Gs^Fp, Gs^Fp, Gs^Fp, Gg^Vh, Gg, Rr, Rr, Rr, Rr, Rr, Gg, Gg^Vh, Re^Gvs, Re^Gvs, Re^Gvs, Gg, Ce, Wo, Wo
Wo, Wo, Ce, Gg, Gs^Fp, Gs^Fp, Rr, Rr, Gg, Gg, 4 Ke, Gg, Gg, Rr, Rr, Gg, Gg, Gg, Gg, Ce, Wo, Wo
Wo, Wo, Ce, Gg, Gg, Rr, Gg, Gg, Ce, Ce, Rd, Ce, Ce, Gg, Gg, Rr, Rr^Vhc, Gg, Gg, Ce, Wo, Wo
Wo, Wo, Ce, Gg, Gg, Rr, Gs, Gs, Ce, Rd, Rd, Rd, Ce, Gg, Gg, Rr, Gg, Gg, Gg, Ce, Wo, Wo
Wo, Wo, Ce, Gg, Gg, Rr, Gg^Ve, Gs, Gg, Ce, Ce, Ce, Gg, Gg, Gg^Ve, Rr, Gs, Gs, Gs, Ce, Wo, Wo
Wo, Wo, Ce, Cud, Cud, Rr, Gg, Gg, Gg, Gg, Rr, Gg, Gg, Gg, Gg, Rr, Gg, Gs, Gs, Ce, Wo, Wo
Wo, Wo, Ce, Gs^Fp, Rr, Rr, Ww, Gg, Gg, Ch, 3 Kh, Ch, Gg, Gs, Gs, Rr, Gg^Vh, Gg, Gg, Ce, Wo, Wo
Wo, Wo, Ce, Rr^Vhc, Cud, Rr, Rr, Ww, Gg, Ch, Rr, Ch, Gg, Gs, Rr, Rr, Re, Gg, Gg, Ce, Wo, Wo
Wo, Wo, Ce, Cud, Gs^Fp, Ww, Ww, Ww^Bw\, Rr, Gg, Rr, Gg, Rr, Rr, Gg^Vh, Gg, Gg, Re, Gg, Ce, Wo, Wo
Wo, Wo, Ce, Gs^Fp, Gs^Fp, Gs^Fp, Gs^Fp, Gg, Gs, Rr, Rr, Rr, Gs, Gg, Gg, Gg, Gg, Gs^Vht, Gg, Ce, Wo, Wo
Wo, Wo, Ce, Gg, Gg, Gg, Gg, Gg, Gg, Gs, Rr, Gg, Gg, Gs, Gg, Gg, Gg, Gg, Gg, Ce, Wo, Wo
Wo, Wo, Ce, Ce, Ce, Ce, Ce, Ce, Ce, Ce, Rr, Ce, Ce, Ce, Ce, Ce, Ce, Ce, Ce, Ce, Wo, Wo
Wo, Wo, Wo, Wo, Wo, Wo, Wo, Wo, Wo, Wo, Wo^Bw|, Wo, Wo, Wo, Wo, Wo, Wo, Wo, Wo, Wo, Wo, Wo
Wo, Wo, Gg, Wo, Gg, Wo, Gg, Wo, Gg, Wo, Re, Wo, Gg, Wo, Gg, Wo, Gg, Wo, Gg, Wo, Gs^Fp, Gs^Fp
Gg, Gg, Gs^Fp, Gg, Gs^Fp, Gs^Fp, Gs^Fp, Gg, Gg, Gg, Re, Gg, 5 Kh, Gg, Gg, Gg, Gs^Fp, Gg, Gg, Gg, Gs^Fp, Gs^Fp
Gs^Fp, Gs^Fp, Gs^Fp, Gs^Fp, Gs^Fp, Gs^Fp, Gs^Fp, Gs^Fp, Gg, 2 Gg, 1 Kh, Gg, Gg, Gg, Gs^Fp, Gs^Fp, Gs^Fp, Gs^Fp, Gs^Fp, Gs^Fp, Gs^Fp, Gs^Fp
Gs^Fp, Gs^Fp, Gs^Fp, Gs^Fp, Gs^Fp, Gs^Fp, Gs^Fp, Gs^Fp, Gs^Fp, Gg, Re, Gg, Gs^Fp, Gs^Fp, Gs^Fp, Gs^Fp, Gs^Fp, Gs^Fp, Gs^Fp, Gs^Fp, Gs^Fp, Gs^Fp
Gs^Fp, Gs^Fp, Gs^Fp, Gs^Fp, Gs^Fp, Gs^Fp, Gs^Fp, Gs^Fp, Gs^Fp, Gg, Re, Gg, Gs^Fp, Gs^Fp, Gs^Fp, Gs^Fp, Gs^Fp, Gs^Fp, Gs^Fp, Gs^Fp, Gs^Fp, Gs^Fp